#......#........#
#...###...####.#.
....#.....#..#...
....#.......#...#
..#....##........
.......#....###..
.......#....#....
.......#....#....
....####.........