####################################################################################################
#.....#####.............#...............#######....................#.......#..#....................#
#...............#####...#...............#..........................#.......#..#....................#
#..................#....#...............#..................#####...#.......#..#....................#
#.........##########....#...............#..#....#########..........#.......#..#...................##
#...###########....#....#...............########...................#.......#......................##
#...#..............#.......................#...............................#...........#####......##
#...#..............#.......................#...............................#......................##
#...#..............#.......................#...............................#......................##
#...#..............#...................#######.............................#......##########.....###
#...#.......................................................######...............................###
#...#.#####...#...........########.....................................................#..#......#.#
#...#.....########.....................................................................#..#......#.#
#.............#.......................#....#.........##########.....................#..#..#......#.#
#.......########......................#....#........................................#..#..#......#.#
#.............#.................#.....#....#........................................#..#..#......#.#
#.............#.................#.....#....#........................................#..#.........#.#
#.............###########.......#.....#....#............######......................#..#...........#
#....########.#..######.........#.....#....#........................................#..#...........#
#.............#.................#.....#....##########...............................#..............#
#.............#.................#.....#....#........................................#............#.#
#.............######............#.....#....#....#####.................#######....................#.#
#......................########.#..........#.....................................................#.#
#...............................#................................................................#.#
####################################################################################################
